John: happy-dog-blue
Emily: curious-bird-green
Michael: brave-lion-red
Sophia: gentle-cat-yellow
Daniel: calm-ocean-purple
Olivia: wise-elephant-pink
William: cheerful-butterfly-orange
Isabella: clever-fox-gray
James: peaceful-mountain-brown
Ava: kind-rabbit-white
Ethan: loyal-dolphin-black
Mia: playful-panda-silver
Alexander: patient-horse-gold
Charlotte: humble-sparrow-navy
Benjamin: determined-tiger-magenta
Amelia: joyful-fish-cyan
Mason: loving-dove-ivory
Harper: sincere-deer-crimson
Elijah: serene-swan-lilac
Evelyn: modest-hedgehog-turquoise
Liam: radiant-star-indigo
Abigail: harmonious-rainbow-rose
David: resilient-tree-azure
Sofia: caring-bear-violet
Lucas: genuine-breeze-teal
Avery: optimistic-sunshine-ivory
Alexander: adventurous-moonlight-amber
Ella: tranquil-lake-coral
Henry: strong-meadow-peach
Scarlett: graceful-waterfall-lavender
Dylan: clever-spark-firebrick
Madison: creative-dawn-cream
Logan: noble-snowflake-plum
Grace: tender-flower-azure
Aiden: dynamic-wave-sapphire
Riley: pure-cloud-lime
Zoe: magical-forest-tan
Nathan: free-river-mauve
Chloe: radiant-morning-chocolate
Jackson: steady-rock-charcoal
Victoria: mysterious-fog-taupe
Carter: humble-valley-pewter
Penelope: enchanted-cottage-coral
Gabriel: loyal-garden-rosewood
Madelyn: vibrant-field-mint
Ryan: persistent-road-salmon
Sophie: gentle-breeze-peacock
Evan: resilient-cliff-cream
Lily: delicate-leaf-pearl
Matthew: steady-peak-olive
Natalie: peaceful-stream-cyan
Jack: joyful-voyage-umber
Addison: charming-path-azure
Owen: radiant-dusk-slate
Luna: serene-grove-turquoise
Wyatt: adventurous-trail-goldenrod
Aria: harmonious-hilltop-lavender
Grayson: loyal-bond-mustard
Brooklyn: playful-meadow-rose
Levi: wise-canyon-azure
Audrey: gentle-river-amber
Luke: calm-breeze-lilac
Samantha: radiant-horizon-mauve
Christian: steadfast-plateau-coral
Allison: sincere-valley-indigo
Hunter: courageous-forest-olive
Alexa: joyful-bloom-rose
Aaron: resilient-summit-peach
Lauren: serene-vista-taupe
Charles: noble-landscape-charcoal
Aubrey: compassionate-pathway-teal
Landon: strong-ridge-silver
Hannah: tender-petal-sapphire
Connor: dynamic-journey-crimson
Aaliyah: graceful-glen-ivory
Adrian: adventurous-pathfinder-magenta
Bailey: tranquil-trail-tan
Julia: genuine-harbor-pink
Jeremiah: noble-trek-navy
Peyton: caring-pass-cerulean
Angelina: radiant-voyage-azure
Gabriel: loyal-crest-peacock
Molly: joyful-hike-maroon
Robert: steadfast-journey-cream
Kennedy: kind-pathway-salmon
Isaac: resilient-riverbank-ochre
Stella: serene-grove-lime
Cameron: adventurous-venture-turquoise
Violet: gentle-garden-mauve
Jaxon: dynamic-pathway-lilac
Gianna: compassionate-trail-mustard
Elliot: wise-expedition-coral
Lucy: peaceful-journey-slate
Brayden: courageous-trek-cyan
Caroline: serene-pathway-peach
Tristan: steadfast-voyage-amber
Nova: adventurous-journey-olive
Caleb: noble-pathway-rose
Skylar: tranquil-trail-indigo
Autumn: gentle-path-coral
Dominic: dynamic-voyage-silver
Layla: loving-pathway-magenta
Austin: resilient-venture-taupe
Hailey: harmonious-journey-charcoal
Zachary: joyful-exploration-lavender
Eliana: serene-trek-turquoise
Cole: steadfast-path-mustard
Penelope: playful-expedition-crimson
Ryder: courageous-journey-ivory
Aurora: compassionate-voyage-peacock
Justin: patient-pathway-salmon
Mariah: radiant-trail-lime
Asher: adventurous-journey-azure
Maya: serene-pathway-ochre
Blake: brave-exploration-navy
Sophia: sincere-voyage-cream
Max: resilient-trek-teal
Nova: nurturing-journey-mauve
Gavin: gentle-pathfinder-pearl
Ruby: radiant-voyage-amber
Adeline: adventurous-journey-olive
Parker: peaceful-pathway-rose
Leah: loyal-trek-indigo
Damian: daring-journey-coral
Melanie: magical-pathway-silver
Nolan: noble-voyage-lavender
Sadie: serene-trail-turquoise
Hudson: hearty-pathway-mustard
Harmony: harmonious-journey-crimson
Colton: courageous-exploration-ivory
Elena: elegant-voyage-peacock
Milo: mindful-pathway-salmon
Naomi: nurturing-journey-lime
Caden: courageous-trek-azure
Juliette: joyful-voyage-ochre
Easton: enduring-path-navy
Ariana: adventurous-journey-cream
Jasper: joyful-exploration-teal
Lyla: loving-trail-mauve
Zane: zealous-voyage-pearl
Kylie: kind-pathfinder-amber
Jace: joyful-trek-olive
Valentina: vibrant-journey-rose
Ronan: resilient-pathway-indigo
Evangeline: enchanting-voyage-coral
Sawyer: steady-exploration-silver
Nova: nurturing-path-lavender
Declan: daring-journey-turquoise
Danielle: delicate-trail-mustard
Tucker: tranquil-voyage-crimson
Vivian: vibrant-journey-ivory
Maxwell: mindful-pathway-peacock
Emery: enduring-journey-salmon
Oscar: optimistic-trek-lime
Claire: courageous-pathway-azure
Beckett: brave-exploration-ochre
Juliana: joyful-voyage-navy
Graham: genuine-trail-cream
Rowan: resilient-journey-teal
Harper: hearty-pathway-mauve
Santiago: sincere-voyage-pearl
Lillian: loving-journey-amber
Jett: joyful-trek-olive
Elise: enchanting-path-rose
Finnegan: fearless-voyage-indigo
Emerson: enduring-journey-coral
Kennedy: kind-pathway-silver
Isaiah: intuitive-trek-lavender
Giselle: graceful-exploration-turquoise
Archer: adventurous-pathway-mustard
Lydia: luminous-voyage-crimson
Weston: wise-journey-ivory
Kinsley: kind-hearted-trek-peacock
Dominick: dynamic-pathway-salmon
Raegan: radiant-voyage-lime
Brooks: brave-exploration-azure
Elaina: enchanting-journey-ochre
Caleb: calm-pathway-navy
Everleigh: energetic-voyage-cream
Jensen: joyful-trek-teal
Cora: compassionate-pathway-mauve
Dean: daring-journey-pearl
Phoenix: peaceful-voyage-amber
Ember: enduring-pathway-olive
Keith: kind-hearted-trek-rose
Leilani: loving-journey-indigo
Gideon: graceful-exploration-coral
Brielle: brave-voyage-silver
Jaxton: joyful-trek-lavender
Elle: enchanting-pathway-turquoise
Marshall: mindful-journey-mustard
Hayden: hopeful-voyage-crimson
Alessandra: adventurous-exploration-ivory
Soren: serene-pathway-peacock
Cassandra: calm-journey-salmon
Lincoln: luminous-trek-lime
Skyler: steadfast-pathway-azure
Rosemary: radiant-voyage-ochre
Dawson: daring-exploration-navy
Thea: tranquil-journey-cream
Cohen: courageous-pathway-teal
Alana: adventurous-voyage-mauve
Luca: loving-trek-pearl
Selena: serene-exploration-amber
Jonah: joyful-pathway-olive
Ada: adventurous-journey-rose
Knox: kind-hearted-trek-indigo
Miranda: mindful-voyage-coral
Reid: resilient-pathway-silver
Gemma: graceful-exploration-lavender
Daxton: daring-trek-turquoise
Raelyn: radiant-pathway-mustard
Eden: enduring-journey-crimson
Karter: kind-hearted-voyage-ivory
Bianca: brave-exploration-peacock
Enzo: energetic-trek-salmon
Aubree: adventurous-pathway-lime
Waylon: wise-journey-azure
Josie: joyful-voyage-ochre
Carter: courageous-pathway-navy
Athena: adventurous-voyage-cream
Mark: brave-squirell-internship
Hayes: hopeful-trek-teal
Lia: luminous-pathway-mauve
Ryker: resilient-journey-pearl
Sylvie: serene-exploration-amber
Gage: grateful-voyage-olive
Mara: magical-trek-rose
Bryson: brave-pathway-indigo
Nia: nurturing-journey-coral
Elian: enduring-exploration-silver
Livia: loving-voyage-lavender
Rylan: radiant-pathway-turquoise
Kiera: kind-hearted-trek-mustard
Joel: joyful-voyage-crimson
Alaric: adventurous-journey-ivory
Elora: elegant-exploration-peacock
Sutton: sincere-trek-salmon
Alistair: adventurous-pathway-lime
Brynn: brave-voyage-azure
Kyler: kind-hearted-journey-cream
Aurelia: adventurous-trek-ochre
Emilia: enchanting-pathway-navy
Colt: courageous-voyage-teal
Maren: mindful-trek-mauve
Kaiya: kind-hearted-journey-pearl
Benton: brave-exploration-amber
Ivy: inspiring-pathway-olive
Colson: courageous-voyage-rose
Anya: adventurous-journey-indigo
Arlo: artistic-trek-coral
Calliope: cheerful-voyage-silver
Lachlan: luminous-pathway-lavender
Elodie: enchanting-journey-turquoise
Wren: wise-trek-mustard
Kellan: kind-hearted-voyage-cream
Noelle: nurturing-pathway-ochre
Maddox: brave-exploration-navy
Freya: fearless-journey-peacock
Conrad: courageous-voyage-salmon
Anastasia: adventurous-trek-lime
Ezra: energetic-pathway-azure
Lennon: luminous-voyage-ochre
Margot: mindful-journey-ivory
Knox: kind-hearted-trek-pearl
Jolie: joyful-voyage-amber
Zara: zealous-pathway-olive
Nico: nurturing-trek-rose
Rhea: radiant-journey-indigo
Byron: brave-exploration-coral
Livia: loving-voyage-silver
Thalia: tranquil-pathway-lavender
Cassius: courageous-trek-turquoise
Adriana: adventurous-voyage-mustard
Jonas: joyful-journey-cream
Ayla: adventurous-trek-navy
Hugo: hopeful-pathway-peacock
Esme: enduring-voyage-salmon
Dante: daring-exploration-lime
Anneliese: adventurous-trek-azure
Orion: optimistic-voyage-ochre
Sawyer: steady-pathway-ivory
Lyra: luminous-journey-pearl
Remy: radiant-trek-amber
Seraphina: sincere-voyage-olive
Kian: kind-hearted-journey-rose
Nyla: nurturing-pathway-indigo
Axl: adventurous-voyage-coral
Saoirse: steadfast-trek-silver
Zephyr: zealous-pathway-lavender
Marlowe: mindful-journey-turquoise
Evangeline: enduring-voyage-mustard
Emory: elegant-trek-cream
Caspian: courageous-exploration-navy
Juniper: joyful-pathway-peacock
Ronin: radiant-trek-salmon
Sloane: serene-voyage-lime
Castiel: courageous-journey-azure
Poppy: peaceful-trek-ochre
Atticus: adventurous-pathway-ivory
Leia: luminous-voyage-pearl
Archer: adventurous-trek-amber
Elara: elegant-pathway-olive
Cian: courageous-voyage-rose
Octavia: optimistic-trek-indigo
Cedric: courageous-pathway-coral
Sylvie: serene-voyage-silver
Bodhi: brave-journey-lavender
Kara: kind-hearted-trek-turquoise
Dorian: daring-voyage-mustard
Amira: adventurous-pathway-cream
Flynn: fearless-trek-navy
Zora: zealous-voyage-peacock
Rhett: radiant-pathway-salmon
Briar: brave-journey-lime
Elio: energetic-trek-azure
Calista: courageous-voyage-ochre
Lorcan: luminous-pathway-ivory
Kaia: kind-hearted-journey-pearl
Thaddeus: steadfast-trek-amber
Elowen: elegant-voyage-olive
Cyrus: courageous-pathway-rose
Mavis: mindful-journey-indigo
Clio: cheerful-voyage-coral
Lorcan: luminous-trek-silver
Leona: loving-pathway-lavender
Zara: zealous-voyage-turquoise
Jovan: joyful-trek-mustard
Saoirse: steadfast-voyage-cream
Evander: enduring-pathway-navy
Maeve: magical-journey-peacock

